[console_scripts]
kepbls = pyke.kepbls:kepbls_main
kepclean = pyke.kepclean:kepclean_main
kepclip = pyke.kepclip:kepclip_main
kepconvert = pyke.kepconvert:kepconvert_main
kepcotrend = pyke.kepcotrend:kepcotrend_main
kepdetrend = pyke.kepdetrend:kepdetrend_main
kepdiffim = pyke.kepdiffim:kepdiffim_main
kepdraw = pyke.kepdraw:kepdraw_main
kepdynamic = pyke.kepdynamic:kepdynamic_main
kepextract = pyke.kepextract:kepextract_main
kepffi = pyke.kepffi:kepffi_main
kepfilter = pyke.kepfilter:kepfilter_main
kepflatten = pyke.kepflatten:kepflatten_main
kepfold = pyke.kepfold:kepfold_main
kephead = pyke.kephead:kephead_main
kepimages = pyke.kepimages:kepimages_main
kepmask = pyke.kepmask:kepmask_main
kepoutlier = pyke.kepoutlier:kepoutlier_main
keppca = pyke.keppca:keppca_main
kepperiodogram = pyke.kepperiodogram:kepperiodogram_main
keppixseries = pyke.keppixseries:keppixseries_main
kepprf = pyke.kepprf:kepprf_main
kepprfphot = pyke.kepprfphot:kepprfphot_main
keprange = pyke.keprange:keprange_main
kepsff = pyke.kepsff:kepsff_main
kepsmooth = pyke.kepsmooth:kepsmooth_main
kepstddev = pyke.kepstddev:kepstddev_main
kepstitch = pyke.kepstitch:kepstitch_main
keptimefix = pyke.keptimefix:keptimefix_main
keptrial = pyke.keptrial:keptrial_main
keptrim = pyke.keptrim:keptrim_main
kepwindow = pyke.kepwindow:kepwindow_main

